□□□□□□□□□□□□□□□□□□□□□□□□□□□□□□□□□□□□□□□□□□□□□□□□□□□□□□□□□□□□□□□□□□□□□□□□□□□□□□□□□□□□□□□□□□□□□□□□□□□□
□□□□□□□□□□□□□□□□□□□□□□□□□□□□□□□□□□□□□□□□□□□□□□□□□□□□□□□□□□□□□□□□□□□□□□□□□□□□□□□□□□□□□□□□□□□□□□□□□□□□
□□□□□□□□□□□□□□□□□□□□□□□□□□□□□□□□□□□□□□□□□□□□□□□□□□□□□□□□□□□□□□□□□□□□□□□□□□□□□□□□□□□□□□□□□□□□□□□□□□□□
□□□□□□□□□□□□□□□□□□□□□□□□□□□□□□□□□□□□□□□□□□□□□□□□□□□□□□□□□□□□□□□□□□□□□□□□□□□□□□□□□□□□□□□□□□□□□□□□□□□□
□□□□□□□□□□□□□□□□□□□□□□□□□□□□□□□□□□□□□□□□□□□□□□□□□□□□□□□□□□□□□□□□□□□□□□□□□□□□□□□□□□□□□□□□□□□□□□□□□□□□
□□□□□□□□□□□□□□□□□□□□□□□□□□□□□□□□□□□□□□□□□□□□□□□□□□□□□□□□□□□□□□□□□□□□□□□□□□□□□□□□□□□□□□□□□□□□□□□□□□□□
□□□□□□□□□□□□□□□□□□□□□□□□□□□□□□□□□□□□□□□□□□□□□□□□□□□□□□□□□□□□□□□□□□□□□□□□□□□□□□□□□□□□□□□□□□□□□□□□□□□□
□□□□□□□□□□□□□□□□□□□□□□□□□□□□□□□□□□□□□□□□□□□□□□□□□□□□□□□□□□□□□□□□□□□□□□□□□□□□□□□□□□□□□□□□□□□□□□□□□□□□
□□□□□□□□□□□□□□□□□□□□□□□□□□□□□□□□□□□□□□□□□□□□□□□□□□□□□□□□□□□□□□□□□□□□□□□□□□□□□□□□□□□□□□□□□□□□□□□□□□□□
□□□□□□□□□□□□□□□□□□□□□□□□□□□□□□□□□□□□□□□□□□□□□□□□□□□□□□□□□□□□□□□□□□□□□□□□□□□□□□□□□□□□□□□□□□□□□□□□□□□□
□□□□□□□□□□□□□□□□□□□□□□□□□□□□□□□□□□□□□□□□□□□□□□□□□□□□□□□□□□□□□□□□□□□□□□□□□□□□□□□□□□□□□□□□□□□□□□□□□□□□
□□□□□□□□□□□□□□□□□□□□□□□□□□□□□□□□□□□□□□□□□□□□□□□□□□□□□□□□□□□□□□□□□□□□□□□□□□□□□□□□□□□□□□□□□□□□□       
□□□□□□□□□□□□□□□□□□□□□□□□□□□□□□□□□□□□□□□□□□□□□□□□□□□□□□□□□□□□□□□□□□□□□□□□□□□□□□□□□□□□□□□□□□□□□       
□□□□□□□□□□□□□□□□□□□□□□□□□□□□□□□□□□□□□□□□□□□□□□□□□□□□□□□□□□□□□□□□□□□□□□□□□□□                         
□□□□□□□□□□□□□□□□□□□□□□□□□□□□□□□□□□□□□□□        □□□□□□□□□□□□□□□□□□□□□□□□□□□□                         
□□□□□□□□□□□□□□□□□□□□□□□□□□□□□□□□□□□□□□□        □□□□□□□□□□□□□□□□□□□□□□□□□□□□    □□□□□□□□□□□□□□       
□□□       □□□□□□□□□□□□□□□□□□□□□□□□□□□□□        □□□□□□□□□□□□□□□□□□□□□□□□□□□□    □□□□□□□□□□□□□□□□□  □□
□□□       □□□□□□□□□□□□□□□□□□□□□□□□□□□□□        □□□□□□□□□□□□□□□□□□□□□□□□□□□□    □□□□□□□□□□□□□□□□□  □□
□□□                                                                                               □□
□□□                                                                                              □□□
□□□       □□□□  □□□□□□□□  □□□□□□□□□□□□□□□□□□□□□□□□□□□□□□□□□□□□□□□□□□□□□□□□□    □□□□□□□□□□□□□□□□□□□□□
□□□□□□□□□□□□□□  □□□□□□□□  □□□□□□□□□□□□□□□□□□□□□□□□□□□□□□□□□□□□□□□□□□□□□□□□□    □□□□□□□□□□□□□□□□□□□□□
□□□□□□□□□□□□□□  □□□□□□□□  □□□□□□□□□□□□□□□□□□□□□□□□□□□□□□□□□□□□□□□□□□□□□□□□□    □□□□□□□□□□□□□□□□□□□□□
□□□□□□□□□□□□□□  □□□□□□□□  □□□□□□□□□□□□□□□□□□□□□□□□□□□□□□□□□□□□□□□□□□□□□□□□□    □□□□□□□□□□□□□□□□□□□□□
□□□□□□□□□□□□□□  □□□□□□□□  □□□□□□□□□□□□□□□□□□□□□□□□□□□□□□□□□□□□□□□□□□□□□□□□□    □□□□□□□□□□□□□□□□□□□□□
□□□□□□□□□□        □□□□□□  □□□□□□□□□□□□□□□□□□□□□□□□□□□□□□□□□□□□□□□□□□□□□□□□□    □□□□□□□□□□□□□□□□□□□□□
□□□□□□□□□□        □□□□□□  □□□□□□□□□□□□□□□□□□□□□□□□□□□□□□□□□□□□□□□□□□□□□□□□□    □□□□□□□□□□□□□□□□□□□□□
□□□□□□□□□□        □□□□□□  □□□□□□□□□□□□□□□□□□□□□□□□□□□□□□□□□□□□□□□□□□□□□□□□□    □□□□□□□□□□□□□□□□□□□□□
□□□□□□□□□□        □□□□□□  □□□□□□□□□□□□□□□□□□□□□□□□□□□□□□□□□□□□□□□□□□□□□□□□□    □□□□□□□□□□□□□□□□□□□□□
□□□□□□□□                                □□□□□□□□□□□□□□□□□□□□□□□□□□□□□□□□□□□    □□□□□□□□□□□□□□□□□□□□□
□□□□□□□□                                □□□□□□□□□□□□□□□□□□□□□□□□□□□□□□□□□□□    □□□□□□□□□□□□□□□□□□□□□
□□□□□□□□          □□□□□□  □□□□□□□□□□□□  □□□□□□□□□□□□□□□□□□□□□□□□□□□□□□□□□□□    □□□□□□□□□□□□□□□□□□□□□
□□□□□□□□          □□□□□□  □□□□□□□□□□□□  □□□□□□□□□□□□□□□□□□□□□□□□□□□□□□□□□□□    □□□□□□□□□□□□□□□□□□□□□
□□□□□□□□  □□□□□□□□□□□□□□  □□□□□□□□□□□□  □□□□□□□□□□□□□□□□□□□□□□□□□□□□□□□□□□□    □□□□□□□□□□□□□□□□□□□□□
□□□□□□□□  □□□□□□□□□□□□□□  □□□□□□□□□      □□□□□□□□□□     □□□□□□□□□□□□□□□□□□□    □□□□□□□□□□□□□□□□□□□□□
□□□□□□□□  □□□□□□□□□□□□□□  □□□□□□□□□      □□□□□□□□□□     □□□□□□□□□□□□□□□□□□□    □□□□□□□□□□□□□□□□□□□□□
□□□□□□□□  □□□□□□□□□□□□□□  □□□□□□                        □□□□□□□□□□□□□□□□□□□    □□□□□□□□□□□□□□□□□□□□□
□□□□□□□□  □□□□□□□□□       □□□□□□                        □□□□□□□□□□□□□□□□□□□    □□□□□□□□□□□□□□□□□□□□□
□□□□□□□□  □□□□□□□□□ □□□□  □□□□□□  □      □□□□□□□□□□     □□□□□□□□□□□□□□□□□□□    □□□□□□□□□□□□□□□□□□□□□
□□□□□□□□  □□□□□□□□□ □□□□  □□□□□□  □□□□□□□□□□□□□□□□□     □□□□□□□□□□□□□□□□□□□    □□□□□□□□□□□□□□□□□□□□□
□□□□□□□□  □□□□□□□□□ □□□□  □□□□□□  □□□□□□□□□□□□□□□□□     □□□□□□□□□□□□□□□□□□□    □□□□□□□□□□□□□□□□□□□□□
□□□□□□□□  □□□□□□□□□ □□□□  □□□□□□  □□□□□□□□□□□□□□□□□□□□□□□□□□□□□□□□□□□□□□□□□    □□□□□□□□□□□□□□□□□□□□□
□□□□□□□□  □□□□□□□□□ □□□□  □□□□□□  □□□□□□□□□□□□□□□□□□□□□□□□□□□□□□□□□□□□□□□□□    □□□□□□□□□□□□□□□□□□□□□
□□□□□□□□  □□□□□□□□□ □□□□  □□□□□□  □□□□□□□□□□□□□□□□□□□□□□□□□□□                  □□□□□□□□□□□□□□□□□□□□□
□□□□□□□□  □□□□□□□□□ □□□□  □□□□□□  □□□□□□□□□□□□□□□□□□□□□□□□□□□  □□□□□□□□□□□□    □□□□□□□□□□□□□□□□□□□□□
□□□□□□□□  □□□□□□□□□ □□□□  □□□□□□  □□□□□□□□□□□□□□□□□□□□□□□□□□□  □□□□□□□□□□□□    □□□□□□□□□□□□□□□□□□□□□
□□□□□□□□  □□□□□□□□□ □□□□  □□□□□□  □□□□□□□□□□□□□□□□□□□□□□□□□□□  □□□□□□□□□       □□□□□□□□□□□□□□□□□□□□□
□□□□□□□□  □□□□□□□□□ □□□□  □□□□□□  □□□□□□□□□□□□□□□□□□□□□□□□□□□  □□□□□□□□□       □□□□□□□□□□□□□□□□□□□□□
□□□□□□□□  □□□□□□□□□ □□□□  □□□□□□  □□□□□□□□□□□□□□□□□□□□□□□□□□□  □□□□□□□□□       □□□□□□□□□□□□□□□□□□□□□
□□□□□□     □□□□□□□□ □□□□  □□□□□□  □□□□□□□□□□□□□□□□□□□□□□□□□□□  □□□□□□□□□       □□□□□□□□□□□□□□□□□□□□□
□□□□□□     □□□□□□□□ □□□□  □□□□□□  □□□□□□□□□□□□□□□□□□□□□□□□□□□  □□□□□□□□□       □□□□□□□□□□□□□□□□□□□□□
□□□□□□     □□□□□□□□ □□□□  □□□□□□  □□□□□□□□□□□□□□□□□□□□□□□□□□□  □□□□□□□□□       □□□□□□□□□□□□□□□□□□□□□
□□□□□□     □□□□□□□□ □□□□  □□□      □□□□□□□□□□□□□□□□□□□□□□□□□□  □□□□□□□□□       □□□□□□□□□□□□□□□□□□□□□
□□□□□□     □□□□□□□□ □□□□  □□□      □□□□□□□□□□□□□□□□□□□□□□□□□□  □□□□□□□□□□□□    □□□□□□□□□□□□□□□□□□□□□
□□□□□□     □□□□□□□□ □□□□  □□□      □□□□□□□□□□□□□□□□□□□□□□□□□□  □□□□□□□□□□□□    □□□□□□□□□□□□□□□□□□□□□
□□□□□□     □□□□□□□□ □□□□  □□□      □□□□□□□□□□□□□□□□□□□□□□□□□□  □□□□□□□□□□□□    □□□□□□□□□□□□□□□□□□□□□
□□□□□□     □□□□□□□□ □□□□  □□□                       □□□□□□□□□  □□□□□□□□□□□□    □□□□□□□□□□□□□□□□□□□□□
□□□□□□□□□□□□□□□□□□□ □□□□  □□□                       □□□□□□□□□                  □□□□□□□□□□□□□□□□□□□□□
□□□□□□□□□□□□□□□□□□□ □□□□  □□□      □□□□□□□□□□□□□□□  □□□□□□□□□□□□□□□□□□□□□□□□   □□□□□□□□□□□□□□□□□□□□□
□□□□□□□□□□□□□□□□□□□ □□□□  □□□      □□□□□□□□□□□□□□□  □□□□□□□□□□□□□□□□□□□□□□□□   □□□□□□□□□□□□□□□□□□□□□
□□□□□□□□□□□□□□□□□□□ □□□□  □□□□□□□□□□□□□□□□□□□□□□□□  □□□□□□□□□□□□□□□□□□□□□        □□□□□□□□□□□□□□□□□□□
□□□□□□□□□□□□□□□□□□□ □□□□  □□□□□□□□□□□□□□□□□□□□□       □□□□□□□□□□□□□□□□□□□        □□□□□□□□□□□□□□□□□□□
□□□□□□□□□□□□□□□□□□□ □□□□  □□□□□□□□□□□□□□□□□□□□□       □□□□□□□□□□□□□□□□□□□        □□□□□□□□□□□□□□□□□□□
□□□□□□□□□□          □□□□  □□□□□□□□□□□□□□□□□□□□□       □□□□□□□□□□□□□□□□□□□        □□□□□□□□□□□□□□□□□□□
□□□□□□□□□□ □□□□□□□□□□□□□  □□□□□□□□□□□□□□□□□□□□□       □□□□□□□□□□□□□□□□□□□        □□□□□□□□□□□□□□□□□□□
□□□□□□□□□□ □□□□□□□□□□□□□  □□□□□□□□□□□□□□□□□□□□□       □□□□□□□□□□□□□□□□□□□        □□□□□□□□□□□□□□□□□□□
□□□□□□□□□□ □□□□□□□□□□□□□  □□□□□□□□□□□□□□□□□□□□□□□□□□□□□□□□□□□□□□□□□□□□□□□        □□□□□□□□□□□□□□□□□□□
□□□□□□□□□□ □□□□□□□□□□□□□  □□□□□□□□□□□□□□□□□□□□□□□□□□□□□□□□□□□□□□□□□□□□□□□□□□  □□□□□□□□□□□□□□□□□□□□□□
□□□□□□□□□□ □□□□□□□□□□□□□  □□□□□□□□□□□□□□□□□□□□□□□□□□□□□□□□□□□□□□□□□□□□□□□□□□  □□□□□□□□□□□□□□□□□□□□□□
□□□□□□□□□□ □□□□□□□□□□□□□  □□□□□□□□□□□□□□□□□□□□□□□□□□□□□□□□□□□□□□□□□□□□□□□□□□  □□□□□□□□□□□□□□□□□□□□□□
□□□□□□□□□□ □□□□□□□□□□□□□  □□□□□□□□□□□□□□□□□□□□□□□□□□□□□□□□□□□□□□□□□□□□□□□□□□  □□□□□□□□□□□□□□□□□□□□□□
□□□□□□□□□□ □□□□□□□□□□□□□  □□□□□□□□□□□□□□□□□□□□□□□□□□□□□□□□□□□□□□□□□□□□□□□□□□  □□□□□□□□□□□□□□□□□□□□□□
□□□□□□□□□□ □□□□□□□□□□□□□  □□□□□□□□□□□□□□□□□□□□□□□□□□□□□□□□□□□□□□□□□□□□□□□□□□  □□□□□□□□□□□□□□□□□□□□□□
□□□□□□□□□□ □□□□□□□□□□□□□  □□□□□□□□□□□□□□□□□□□□□□□□□□□□□□□□□□□□□□□□□□□□□□□□□□  □□□□□□□□□□□□□□□□□□□□□□
□□□□□□□□□□ □□□□□□□□□□□□□  □□□□□□□□□□□□□□□□□□□□□□□□□□□□□□□□□□□□□□□□□□□□□□□□□□  □□□□□□□□□□□□□□□□□□□□□□
□□□□□□□□□□ □□□□□□□□□□□□□  □□□□□□□□□□□□□□□□□□□□□□□□□□□□□□□□□□□□□□□□□□□□□□□□□□  □□□□□□□□□□□□□□□□□□□□□□
□□□□□□□□□□ □□□□□□□□□□□□□  □□□□□□□□□□□□□□□□□□□□□□□□□□□□□□□□□□□□□□□□□□□□□□□□□□  □□□□□□□□□□□□□□□□□□□□□□
□□□□□□□□□□ □□□□□□□□□□□□□  □□□□□□□□□□□□□□□□□□□□□□□□□□□□□□□□□□□□□□□□□□□□□□□□□□  □□□□□□□□□□□□□□□□□□□□□□
□□□□□□□□□□ □□□□□□□□□□□□□  □□□□□□□□□□□□□□□□□□□□□□□  □□□□□□□□□□□□□□□□□□□□□□□□□  □□□□□□□□□□□□□□□□□□□□□□
□□□□□□□□□□ □□□□□□□□□□□□□  □□□□□□□□□□□□□□□□□□□□□□□  □□□□□□□□□□□□□□□□□□□□□□□□□  □□□□□□□□□□□□□□□□□□□□□□
□□□□□□□□□□ □□□□□□□□□□□□□  □□□□□□□□□□□□□□□□□□□□□□□  □□□□□□□□□□□□□□□□□□□□□□□□□  □□□□□□□□□□□□□□□□□□□□□□
□□□□□□□□□□ □□□□□□□□□□       □□□□□□□□□□□□□□□□□□□□□  □□□□□□□□□□□□□□□□□□□□□□□□□  □□□□□□□□□□□□□□□□□□□□□□
□□□□□□□□□□ □□□□□□□□□□       □□□□□□□□□□□□□□□□□□□□□  □□□□□□□□□□□□□□□□□□□□□□□□□  □□□□□□□□□□□□□□□□□□□□□□
□□□□□□□□□□ □□□□□□□□□□       □□□□□□□□□□□□□□□□□□□□□  □□□□□□□□□□□□□□□□□□□□□□□□□  □□□□□□□□□□□□□□□□□□□□□□
□□□□□□□□□□ □□□□□□□□□□       □□□□□□□□□□□□□□□□□□□□□  □□□□□□□□□□□□□□□□□□□□□□□□□  □□□□□□□□□□□□□□□□□□□□□□
□□□□□□□□□□ □□□□□□□□□□                                       □□□□□□□□□□□□□□□□  □□□□□□□□□□□□□□□□□□□□□□
□□□□□□□□□□ □□□□□□□□□□                                       □□□□□□□□□□□□□□□□  □□□□□□□□□□□□□□□□□□□□□□
□□□□□□□□□□ □□□□□□□□□□       □□□□□□□□□□□□□□□□□□□□□□□□□□□□□□  □□□□□□□□□□□□□□□□  □□□□□□□□□□□□□□□□□□□□□□
□□□□□□□□□□ □□□□□□□□□□       □□□□□□□□□□□□□□□□□□□□□□□□□□□□□□  □□□□□□□□□□□□□□□□  □□□□□□□□□□□□□□□□□□□□□□
□□□□□□□□□□ □□□□□□□□□□□□□□□□□□□□□□□□□□□□□□□□□□□□□□□□□□□□      □□□□□□□□□□□□□□□  □□□□□□□□□□□□□□□□□□□□□□
□□□□□□□□□□ □□□□□□□□□□□□□□□□□□□□□□□□□□□□□□□□□□□□□□□□□□□□      □□□□□□□□□□□□□□□  □□□□□□□□□□□□□□□□□□□□□□
□□□□□□□□□□ □□□□□□□□□□□□□□□□□□□□□□□□□□□□□□□□□□□□□□□□□□□□      □□□□□□□□□□□□□□□  □□□□□□□□□□□□□□□□□□□□□□
□□□□□□□□□□ □□□□□□□□□□□□□□□□□□□□□□□□□□□□□□□□□□□□□□□□□□□□      □□□□□□□□□□□□□□□  □□□□□□□□□□□□□□□□□□□□□□
□□□□□□□□□□ □□□□□□□□□□□□□□□□□□□□□□□□□□□□□□□□□□□□□□□□□□□□      □□□□□□□□□□□        □□□□□□□□□□□□□□□□□□□□
□□□□□□□□□□ □□□□□□□□□□□□□□□□□□□□□□□□□□□□□□□□□□□□□□□□□□□□      □□□□□□□□□□□        □□□□□□□□□□□□□□□□□□□□
□□□□□□□□□□ □□□□□□□□□□□□□□□□□□□□□□□□□□□□□□□□□□□□□□□□□□□□□□□□□□□□□□□□□□□□□        □□□□□□□□□□□□□□□□□□□□
□□□□□□□□□□                                                            □□     S  □□□□□□□□□□□□□□□□□□□□
□□□□□□□□□□□□□□□□□□□□□□□□□□□□□□□□□□□□□□□□□□□□□□□□□□□□□□□□□□□□□□□□□□□□□□□□        □□□□□□□□□□□□□□□□□□□□
□□□□□□□□□□□□□□□□□□□□□□□□□□□□□□□□□□□□□□□□□□□□□□□□□□□□□□□□□□□□□□□□□□□□□□□□        □□□□□□□□□□□□□□□□□□□□
□□□□□□□□□□□□□□□□□□□□□□□□□□□□□□□□□□□□□□□□□□□□□□□□□□□□□□□□□□□□□□□□□□□□□□□□□□□□□□□□□□□□□□□□□□□□□□□□□□□□
